0	0	4	4	0	1	0	0	1	0	4	4	0	0
0	0	0	0	0	0	0	0	0	0	0	0	0	0
0	0	0	0	0	0	0	0	0	0	0	0	0	0
0	0	1	0	0	0	0	0	0	0	0	1	0	0
1	0	0	0	0	0	0	0	0	0	0	0	0	1
1	0	0	0	0	0	3	3	0	0	0	0	0	1
0	6	0	0	3	0	0	0	0	3	0	0	6	0
-1	7	0	0	0	0	0	0	0	0	0	0	7	-1
7	0	1	0	0	0	0	0	0	0	0	1	0	7
0	0	0	1	0	0	0	0	0	0	1	0	0	0
0	0	0	0	0	6	0	0	6	0	0	0	0	0
0	1	0	0	0	0	0	0	0	0	0	0	1	0
0	0	0	0	0	0	0	0	0	0	0	0	0	0