-1	5	0	0	0	0	0	0	0	0	0	0	0	0
5	0	0	0	0	0	0	0	0	0	0	0	0	0
0	0	0	0	0	0	0	0	0	0	0	0	0	0
0	0	0	0	0	0	0	0	0	0	6	6	0	0
0	0	0	0	0	0	4	3	2	0	-2	6	0	0
0	0	0	0	0	0	3	2	4	3	6	6	0	0
0	0	0	0	0	6	6	6	6	6	6	6	6	0
1	1	1	1	1	1	6	6	6	6	6	6	6	1
1	1	1	1	1	1	1	7	7	7	7	7	1	1
1	1	1	1	1	1	1	1	1	1	1	1	1	1
1	1	1	1	1	1	1	1	1	1	1	1	1	1
0	0	0	0	0	0	0	0	0	0	0	0	0	0
0	0	0	0	0	0	0	0	0	0	0	0	0	0