-2	4	1	1	0	3	-1	-1	3	0	1	1	4	-2
4	1	1	0	0	0	3	3	0	0	0	1	1	4
1	1	0	0	0	0	0	0	0	0	0	0	1	1
1	0	0	0	0	0	0	0	0	0	0	0	0	1
0	0	0	0	0	0	0	0	0	0	0	0	0	0
0	0	0	0	0	0	0	0	0	0	0	0	0	0
0	0	0	0	0	0	0	0	0	0	0	0	0	0
0	0	0	0	0	0	0	0	0	0	0	0	0	0
1	1	1	1	0	0	0	0	0	0	1	1	1	1
-1	-1	3	0	0	0	0	0	0	0	0	3	-1	-1
7	7	3	0	0	0	0	0	0	0	0	3	7	7
1	0	0	0	0	0	0	0	0	0	0	0	0	1
0	0	3	0	0	0	6	6	0	0	0	3	0	0