-1	5	-1	5	-1	5	-2	-2	5	-1	5	-1	5	-1
5	-1	5	-1	5	0	0	0	0	5	-1	5	-1	5
0	0	0	0	0	0	0	0	0	0	0	0	0	0
2	2	2	2	2	0	0	0	0	2	2	2	2	2
2	2	2	2	2	0	7	7	0	2	2	2	2	2
0	0	0	0	0	0	0	0	0	0	0	0	0	0
7	7	0	0	0	1	0	0	1	0	0	0	7	7
1	1	1	1	7	0	0	0	0	7	1	1	1	1
1	1	1	1	7	0	0	0	0	7	1	1	1	1
1	1	1	1	7	0	0	0	0	7	1	1	1	1
1	1	1	1	7	6	0	0	6	7	1	1	1	1
1	1	1	1	6	0	0	0	0	6	1	1	1	1
7	7	7	7	6	0	0	0	0	6	7	7	7	7