-1	5	4	1	0	6	-2	-2	6	0	1	4	5	-1
5	4	0	0	2	0	6	6	0	2	0	0	4	5
4	0	0	0	0	2	0	0	2	0	0	0	0	4
0	0	0	0	0	0	1	1	0	0	0	0	0	0
0	0	0	0	0	2	0	0	2	0	0	0	0	0
0	0	4	0	0	0	1	1	0	0	0	0	0	0
0	4	4	0	0	7	0	0	7	0	0	4	0	0
0	0	0	0	2	0	7	7	0	2	0	4	4	0
0	0	0	0	0	0	0	0	0	0	0	0	0	0
0	0	0	0	0	0	0	0	0	0	0	0	0	0
0	0	0	0	0	0	0	0	0	0	0	0	0	0
0	0	3	0	0	0	0	0	0	0	0	3	0	0
1	1	3	0	0	0	0	0	0	0	0	3	1	1