1	3	1	3	1	3	1	3	1	3	1	3	1	3
3	0	3	0	3	0	3	0	3	0	3	0	3	0
0	3	0	3	0	3	0	3	0	3	0	3	0	3
3	0	3	0	3	0	3	0	3	0	3	0	3	0
0	7	0	7	0	0	-2	-2	0	7	0	7	0	7
7	0	7	0	7	5	5	5	5	0	7	0	7	0
0	0	0	0	0	0	0	0	0	0	0	0	0	0
0	0	0	0	0	0	0	0	0	0	0	0	0	0
0	0	0	0	0	0	0	0	0	0	0	0	0	0
-2	1	0	1	0	0	0	0	0	0	1	0	1	-2
1	0	1	0	1	0	0	0	0	1	0	1	0	1
0	7	0	6	4	6	0	0	6	4	6	0	7	0
7	0	7	0	0	0	0	0	0	0	0	7	0	7