0	0	0	0	0	0	0	0	7	0	0	6	6	0
0	0	0	7	0	0	5	0	0	0	6	5	5	6
-2	3	0	0	5	0	0	0	0	0	6	5	5	6
4	2	0	0	0	0	0	5	0	0	0	6	6	0
0	0	0	0	0	0	1	0	0	0	0	0	0	0
0	0	0	1	0	0	0	0	0	0	0	0	0	0
0	0	0	0	0	0	0	0	0	0	0	0	7	0
0	0	0	0	0	5	0	0	0	5	0	1	0	0
0	0	0	0	0	0	0	7	0	0	0	0	0	0
7	0	5	0	0	0	0	0	0	0	0	0	0	5
0	0	0	7	0	0	0	0	0	0	7	0	0	0
0	0	0	0	0	0	0	0	0	0	0	0	0	0
0	0	0	0	0	0	0	0	0	0	0	0	0	0